#####################################
# Datatypes              (KEYWORD1)
# Functions              (KEYWORD2)
# Structs                (KEYWORD3)
# Constants              (LITERAL1)
#####################################

# esp_dmx.h
ESP_DMX_VERSION_MAJOR	LITERAL1
ESP_DMX_VERSION_MINOR	LITERAL1
ESP_DMX_VERSION_PATCH	LITERAL1
ESP_DMX_VERSION_ID	LITERAL1
ESP_DMX_VERSION_LABEL	LITERAL1
DMX_INTR_FLAGS_DEFAULT	LITERAL1
DMX_INTR_FLAGS_DEFAULT	LITERAL1
DMX_CONFIG_DEFAULT	LITERAL1

# dmx/include/device.h
dmx_get_start_address	KEYWORD2
dmx_set_start_address	KEYWORD2
dmx_get_current_personality	KEYWORD2
dmx_set_current_personality	KEYWORD2
dmx_get_personality_count	KEYWORD2
dmx_get_footprint	KEYWORD2
dmx_get_personality_description	KEYWORD2

# dmx/include/driver.h
dmx_driver_install	KEYWORD2
dmx_driver_delete	KEYWORD2
dmx_driver_disable	KEYWORD2
dmx_driver_enable	KEYWORD2
dmx_driver_is_installed	KEYWORD2
dmx_driver_is_enabled	KEYWORD2
dmx_set_pin	KEYWORD2
dmx_get_baud_rate	KEYWORD2
dmx_set_baud_rate	KEYWORD2
dmx_get_break_len	KEYWORD2
dmx_set_break_len	KEYWORD2
dmx_get_mab_len	KEYWORD2
dmx_set_mab_len	KEYWORD2
dmx_read_offset	KEYWORD2
dmx_read	KEYWORD2
dmx_read_slot	KEYWORD2
dmx_write_offset	KEYWORD2
dmx_write	KEYWORD2
dmx_write_slot	KEYWORD2
dmx_receive_num	KEYWORD2
dmx_receive	KEYWORD2
dmx_send_num	KEYWORD2
dmx_send	KEYWORD2
dmx_wait_sent	KEYWORD2

# dmx/include/parameter.h
dmx_sub_device_get_count	KEYWORD2
dmx_sub_device_exists	KEYWORD2
dmx_parameter_exists	KEYWORD2
dmx_parameter_at	KEYWORD2
dmx_parameter_size	KEYWORD2
dmx_parameter_get	KEYWORD2
dmx_parameter_copy	KEYWORD2
dmx_parameter_set	KEYWORD2
dmx_parameter_commit	KEYWORD2

# dmx/include/types.h
pdDMX_MS_TO_TICKS	KEYWORD2
dmx_start_code_is_valid	KEYWORD2
dmx_start_code_is_rdm	KEYWORD2
dmx_baud_rate_is_valid	KEYWORD2
dmx_break_len_is_valid	KEYWORD2
dmx_mab_len_is_valid	KEYWORD2
rdm_baud_rate_is_valid	KEYWORD2
rdm_break_len_is_valid	KEYWORD2
rdm_mab_len_is_valid	KEYWORD2
DMX_NUM_0	LITERAL1
DMX_NUM_1	LITERAL1
DMX_NUM_2	LITERAL1
DMX_NUM_MAX	LITERAL1
DMX_PIN_NO_CHANGE	LITERAL1
DMX_PACKET_SIZE	LITERAL1
DMX_PACKET_SIZE_MAX	LITERAL1
DMX_BAUD_RATE	LITERAL1
DMX_BAUD_RATE_MIN	LITERAL1
DMX_BAUD_RATE_MAX	LITERAL1
DMX_BREAK_LEN_US	LITERAL1
DMX_BREAK_LEN_MIN_US	LITERAL1
DMX_BREAK_LEN_MAX_US	LITERAL1
DMX_MAB_LEN_US	LITERAL1
DMX_MAB_LEN_MIN_US	LITERAL1
DMX_MAB_LEN_MAX_US	LITERAL1
DMX_TIMEOUT_TICK	LITERAL1
RDM_BREAK_LEN_US	LITERAL1
RDM_BREAK_LEN_MIN_US	LITERAL1
RDM_BREAK_LEN_MAX_US	LITERAL1
RDM_MAB_LEN_US	LITERAL1
RDM_MAB_LEN_MIN_US	LITERAL1
RDM_MAB_LEN_MAX_US	LITERAL1
DMX_SC	LITERAL1
RDM_SC	LITERAL1
RDM_SUB_SC	LITERAL1
RDM_PREAMBLE	LITERAL1
RDM_DELIMITER	LITERAL1
DMX_TEXT_SC	LITERAL1
DMX_TEST_SC	LITERAL1
DMX_UTF8_SC	LITERAL1
DMX_ORG_ID_SC	LITERAL1
DMX_SIP_SC	LITERAL1
dmx_port_t	KEYWORD1
dmx_device_num_t	KEYWORD1
dmx_err_t	KEYWORD1
DMX_OK	LITERAL1
DMX_ERR_TIMEOUT	LITERAL1
DMX_ERR_UART_OVERFLOW	LITERAL1
DMX_ERR_IMPROPER_SLOT	LITERAL1
DMX_FAIL	LITERAL1
DMX_ERR_NOT_ENOUGH_SLOTS	LITERAL1
dmx_config_t	KEYWORD1
dmx_personality_t	KEYWORD1
dmx_packet_t	KEYWORD1
dmx_metadata_t	KEYWORD1
DMX_START_ADDRESS_NONE	LITERAL1

# dmx/sniffer.h
DMX_SNIFFER_INTR_FLAGS_DEFAULT	LITERAL1
dmx_sniffer_enable	KEYWORD2
dmx_sniffer_disable	KEYWORD2
dmx_sniffer_is_enabled	KEYWORD2
dmx_sniffer_get_data	KEYWORD2

# rdm/controller/include/device_control.h
rdm_send_get_identify_device	KEYWORD2
rdm_send_set_identify_device	KEYWORD2

# rdm/controller/include/discovery.h
rdm_disc_cb_t	LITERAL1
rdm_send_disc_unique_branch	KEYWORD2
rdm_send_disc_mute	KEYWORD2
rdm_send_disc_un_mute	KEYWORD2
rdm_discover_with_callback	KEYWORD2
rdm_discover_devices_simple	KEYWORD2

# rdm/controller/include/dmx_setup.h
rdm_send_get_dmx_start_address	KEYWORD2
rdm_send_set_dmx_start_address	KEYWORD2

# rdm/controller/include/product_info.h
rdm_send_get_device_info	KEYWORD2
rdm_send_get_software_version_label	KEYWORD2

# rdm/controller/include/utils.h
rdm_send_request	KEYWORD2
rdm_get_transaction_num	KEYWORD2

# rdm/include/driver.h
rdm_uid_get	KEYWORD2
rdm_read_header	KEYWORD2
rdm_read_pd	KEYWORD2
rdm_write	KEYWORD2
rdm_format_is_valid	KEYWORD2

# rdm/include/types.h
# TODO

# rdm/include/uid.h
rdm_uid_is_eq	KEYWORD2
rdm_uid_is_lt	KEYWORD2
rdm_uid_is_gt	KEYWORD2
rdm_uid_is_le	KEYWORD2
rdm_uid_is_ge	KEYWORD2
rdm_uid_is_broadcast	KEYWORD2
rdm_uid_is_null	KEYWORD2
rdm_uid_is_target	KEYWORD2

# rdm/responder/include/device_control.h
rdm_register_identify_device	KEYWORD2
rdm_get_identify_device	KEYWORD2
rdm_set_identify_device	KEYWORD2

# rdm/responder/include/discovery.h
rdm_register_disc_unique_branch	KEYWORD2
rdm_register_disc_mute	KEYWORD2
rdm_register_disc_un_mute	KEYWORD2

# rdm/responder/include/dmx_setup.h
rdm_register_dmx_personality	KEYWORD2
rdm_get_dmx_personality	KEYWORD2
rdm_set_dmx_personality	KEYWORD2
rdm_register_dmx_personality_description	KEYWORD2
rdm_get_dmx_personality_description	KEYWORD2
rdm_register_dmx_start_address	KEYWORD2
rdm_get_dmx_start_address	KEYWORD2
rdm_set_dmx_start_address	KEYWORD2

# rdm/responder/include/product_info.h
rdm_register_device_info	KEYWORD2
rdm_get_device_info	KEYWORD2
rdm_register_device_label	KEYWORD2
rdm_get_device_label	KEYWORD2
rdm_set_device_label	KEYWORD2
rdm_register_software_version_label	KEYWORD2
rdm_get_software_version_label	KEYWORD2
rdm_register_manufacturer_label	KEYWORD2
rdm_get_manufacturer_label	KEYWORD2

# rdm/responder/include/queue_status.h
rdm_register_queued_message	KEYWORD2
rdm_queue_push	KEYWORD2
rdm_queue_pop	KEYWORD2
rdm_queue_size	KEYWORD2
rdm_queue_previous	KEYWORD2

# rdm/responder/include/rdm_info.h
rdm_register_supported_parameters	KEYWORD2
rdm_register_parameter_description	KEYWORD2

# rdm/respnoder/include/sensor_parameter.h
rdm_register_sensor_value	KEYWORD2
rdm_register_record_sensors	KEYWORD2
rdm_sensor_get_count	KEYWORD2
rdm_sensor_get	KEYWORD2
rdm_sensor_set	KEYWORD2
rdm_sensor_record	KEYWORD2
rdm_sensor_reset	KEYWORD2

# rdm/responder/include/utils.h
rdm_parameter_definition_t	KEYWORD1
rdm_write_ack	KEYWORD2
rdm_write_nack_reason	KEYWORD2
rdm_get_boot_loader	KEYWORD2
rdm_set_boot_loader	KEYWORD2
rdm_simple_response_handler	KEYWORD2
rdm_definition_set	KEYWORD2
rdm_definition_get	KEYWORD2
rdm_callback_set	KEYWORD2

# rdm/controller.h
rdm_ack_t	KEYWORD1

# rdm/responder.h
rdm_callback_t	KEYWORD1
rdm_send_response	KEYWORD2
